111111111111111
100000000000001
100000000000001
111111111011111
100000000010001
100000000010001
100111111110001
10000000000X001
100100000000001
111111111111111